############
# #  .#    #
# #   #  # #
# ##       #
#    $     #
#   ###   ##
# $  #     #
#. $#    # #
##        .#
### # # @  #
############