###########
#     #   #
# $##     #
#     $   #
# .  # #  #
## .      #
# @#    # #
###########