########
#.   .##
# $ $  #
#@$ #  #
#   .# #
#  $# ##
# #.   #
########