##########
#     . ##
# @      #
#.$      #
##   #   #
#  #$ ## #
#        #
###  ##  #
#        #
#  # #   #
#    ##  #
##########