@#########
#        #
#   ###  #
# ## ##  #
#   ##   #
# ##. $  #
# #####  #
#    #   #
#        #
##########