########
#......#
#.####.#
#.#  #.#
#.# @#.#
#.#$ #.#
#.####.#
#......#
########