####
  #  #
  #$ #
###  ###
#  $   #
# .@.  #
#  $   #
###  ###
  #$ #
  #  #
  ####