############
#          #
#          #
#          #
#          #
#          #
#    .@$   #
#          #
#          #
#          #
#          #
############