###############
#             #
#             #
#             #
#             #
#             #
#     .@$     #
#             #
#             #
#             #
#             #
#             #
###############