##########
#..    $ #
# ##     #
#    $ # #
#@    $. #
#    #   #
#        #
#   #    #
##########