########
##   # #
#@     #
#    # #
#  ##  #
#     ##
# $    #
# #  $.#
#  #   #
##    .#
########