##########
#        #
#        #
#        #
#        #
#   .@$  #
#        #
#        #
#        #
##########