############
#    #  #  #
#  $  #  # #
# .       @#
## .  $#   #
#  #       #
#    ## #  #
#  #  # ## #
############